5.0 3.0
    WW    
    WW    
    WW    
    WW    
    WW    

 W        
 W        
 W        
 W        
 W        

       W  
       W  
       W  
       W  
       W  

  W     W 
  W     W 
  W     W 
  W     W 
  W     W 

W        W
 W      W 
  W    W  
   W  W   
    WW    

    WW    
   W  W   
  W    W  
 W      W 
W        W

W    W    
 W    W   
  W    W  
   W    W 
    W    W

    W    W
   W    W 
  W    W  
 W    W   
W    W    
