4.8 2.5
  WWW     
 W   W    
 W   W    
 W   W    
  WWW     

     WWW  
    W   W 
    W   W 
    W   W 
     WWW  

 W   W    
W W     W 
 W  W  W W
   W W  W 
    W     

     W   W
 W  W W   
W W  W  W 
 W     W W
        W 

WW W W W W
          
W W W W W 
          
 W W W W W

++      ++
+        +
          
+        +
++      ++
